WWWWWWWWWW
W........W
W........W
W........W
W....P...W
W........W        WWWWWWWWWW
W........W        W........W
W........WWWWWWWWWW........W
W..........................W
WWWWWWWWWWWWWWWWWWW........W
                  W........W
                  WWWWWWWWWW